AAC - Aachen
ABB - Dongola
ABE - Abenaki
ACH - Principality of Achaia
ADA - Adal
ADE - Aden
ADU - Andalusia
AFA - Afar
AFG - Afghanistan
AHM - Ahmadnagar
AIR - Air
AJU - Ajuuraan
AKK - Ak Koyunlu
AKM - Akamatsu
AKT - Ando
ALB - Albania
ALE - Alencon
ALG - Algiers
ALH - Haasa
ALO - Alodia
ALS - Alsace
AMA - Amago
AMG - Armangnac
ANH - Anhalt
ANN - Annam
ANS - Ansbach
ANT - Antemoro
ANU - Ainu
ANZ - Annizah
APA - Apache
AQU - Aquileia
ARA - Aragon
ARB - Arabia
ARD - Ardalan
ARK - Arakan
ARL - Ardabil
ARM - Armenia
ARP - Arapaho
ARW - Arawak
ASA - Asakura
ASH - Ashanti
ASI - Assiniboine
ASK - Ashikaga
ASS - Assam
AST - Astrakhan
ATH - Duchy of Athens
ATJ - Atjeh
AUG - Augsburg
AUS - Australia
AUV - Auvergne
AVA - Ava
AVI - Avignon
AVR - Avars
AYD - Aydin
AYU - Ayutthaya
AZT - Aztec Empire
BAD - Baden
BAH - Bahmanis
BAL - Baluchistan
BAN - Banten
BAR - Bar
BAV - Bavaria
BDA - Baroda
BEI - Brunei
BEJ - Beja
BEN - Benin
BER - Berry
BGA - Baglana
BGL - Bagelkhand
BHA - Bharat
BHT - Bohtan
BHU - Bhutan
BIJ - Bijapur
BLA - Blackfoot
BLI - Bali
BLM - Blambangan
BLO - Beloozero
BND - Bundelkhand
BNG - Bengal
BNJ - Banjar
BNY - Bunyoro
BOH - Bohemia
BON - bonoman
BOS - Bosnia
BOU - Bourbonnais
BPI - Biapas
BPR - Prome
BRA - Brandenburg
BRB - Brabant
BRE - Bremen
BRI - Brittany
BRR - Berar
BRT - Buryats
BRU - Brunswick
BRZ - Brazil
BSG - Basoga
BSH - Bashkiria
BSR - Basra
BST - Bastar
BTI - Semien
BTL - Bitlis
BTN - Buton
BTS - Betsimisaraka
BTU - Butuan
BUG - Buganda
BUK - Bukhara
BUL - Bulgaria
BUR - Burgundy
BUU - Burundi
BYZ - ByzantineEmpire
CAB - Carib
CAD - Caddo
CAM - UPCA
CAN - Canada
CAS - Castile
CAT - Catalunya
CBA - Chiba
CCQ - Calchaqui
CDL - Dali
CEB - Cebu
CEP - Corfu
CEY - Ceylon
CGS - Changsheng
CHA - Champa
CHC - Chu
CHD - Chanda
CHE - Cherokee
CHG - Chagatai Khanate
CHH - Chahar
CHI - Chickasaw
CHK - Champassak
CHL - Chile
CHM - Chimu
CHO - Choctaw
CHP - Champagne
CHR - Chernigov
CHU - Chukchi
CHV - Chavchuveny
CHY - Cheyenne
CIR - Circassia
CJA - Cajamarca
CKW - Chokwe
CLA - Colla
CLM - Colima
CMI - Miao
CMP - Rewa Kantha
CND - Candar
CNK - Chinook
CNN - Clanricarde
COC - Cocomes
COL - Colombia
COM - Comanche
COR - Corsica
CRA - Charca
CRB - Cirebon
CRE - Creek
CRI - Crimea
CRN - Cornwall
CRO - Croatia
CRT - Crete
CSH - Shun
CSK - Chosokabe
CSU - Cusco
CUA - Charrua
CXI - Xi
CYA - Chachapoya
CYI - Yi
CYP - Cyprus
CZH - Zhou
DAH - dahomey
DAI - Dai Viet
DAM - Damot
DAN - Denmark
DAR - Darfur
DAU - Dauphine 
DAW - Dawasir
DEC - Deccan
DGB - dagbon
DGL - Maldives
DHU - Dhundhar
DLH - Delhi
DMK - Demak
DMS - Desmond
DNG - Dang
DNZ - Danzig
DTE - Date
DTI - Doti
DTT - Ditmarschen
DUL - Dulkadir
EFR - East Frisia
EGY - Egypt
ENA - Eneara
ENG - England
EPI - Despotate of Epirus
ERE - Eretna
EST - Estonia
ETH - Ethiopia
ETR - Etruria
FAD - Fadl
FEO - Theodoro
FER - Ferrara
FEZ - Fez
FIN - Finland
FLA - Flanders
FLY - Faly
FOI - Foix
FOX - Fox
FRA - France
FRI - Friesland
FRN - Frankfurt
FRS - Fars
FUL - Fulo
FZA - Fezzan
GAL - Galicia
GAZ - Gazikumukh
GBR - Great Britain
GDW - Gondwana
GEL - Gelre
GEN - Genoa
GEO - Georgia
GER - Germany
GHD - Djerid
GHR - Garhwal
GLE - Geledi
GLH - Golden Horde
GNG - Gingee
GOC - Golcanda
GOL - Great Horde
GOT - Gotland
GRA - Granada
GRE - Greece
GRJ - Garjat
GRK - Gorkha
GRM - Germiyan
GUA - Guarani
GUG - Guge
GUJ - Gujarat
GUY - Gascony
GWA - Gwalior
HAB - Austria
HAD - Hadoti
HAI - Hainaut
HAM - Hamburg
HAN - Hannover
HAR - Harar
HAT - Haiti
HAU - Hausa
HDA - Haida
HDR - Hadramut
HDY - Hadiya
HED - The Hedjaz
HES - Hessen
HIN - Hindustan
HJA - Huyla
HJO - Hojo
HLR - Holy Roman Empire
HMI - Kara Del
HOB - Hobyo
HOD - Hodyntsy
HOL - Holland
HSA - Hansa
HSC - Highlands
HSE - Hsenwi
HSI - Hsipaw
HSK - Hosokawa
HSN - Hisn Kayfa
HTK - Hatakeyama
HUA - Huai
HUN - Hungary
HUR - Huron
ICE - Iceland
ICM - Ichma
IDR - Idar
IKE - Ikeda
ILK - Ilkhanate
ILL - Illinewek
IME - Imereti
IMG - Imagawa
INC - Inca Empire
IRE - Ireland
IRO - Iroqouis
IRQ - Iraq
ISF - Isfahan
ISK - Isshiki
ITA - Italy
ITO - Ito
ITZ - Itza
JAI - Malta
JAJ - Janjira
JAN - Jangaldesh
JAP - Japan
JFN - Jaffna
JGD - Junagadh
JIM - Jima
JIN - Jin
JJI - Janjiro
JLV - Jhalavad
JML - Jumla
JMN - Jan Mayen
JNN - Jenne
JNP - Jaunpur
JOH - Johor
JOL - Jolof
JPR - Jeypore
JSL - Jaisalmer
KAC - Kachar
KAF - Kaffa
KAL - Kale
KAM - Mdo Khams
KAN - Kano
KAR - Karaman
KAS - Yarkand
KAT - Kathiawar
KAZ - Kazan
KBA - Kabylia
KBO - KanemBornu
KBU - Kaabu
KED - Kedah
KGR - Kangra
KHA - MongolKhanate
KHD - Khandesh
KHI - Khiva
KHM - Khmer
KHO - Khorasan
KIC - Kiche
KID - Kildare
KIE - Kiev
KIK - Kikondja
KIO - Kiowa
KJH - Keonhjar
KKC - Kikuchi
KLD - Kalundwe
KLE - Kleves
KLH - Kalahandi
KLK - Khalkha
KLM - Kalmyk
KLN - Keladi
KLP - Kalpi
KLT - Kolathunad
KMC - Kamchadals
KMN - Kumaon
KMT - Koch
KND - Kandy
KNG - kong
KNI - The Knights
KNO - Kono
KOC - Kochin
KOI - Mann
KOJ - Jerusalem
KOK - Kokkand
KOL - Cologne
KON - Kongo
KOR - Korea
KRA - Krakow
KRC - Khorchin
KRK - Carnatic
KRL - Karelia
KRM - Kerman
KRW - Karagwe
KRY - Biapis
KSD - Khoshuud
KSH - Kashmir
KSJ - Kasanje
KTB - Kitabatake
KTS - Katsina
KTU - Kathmandu
KUB - Kuba
KUR - Courland
KUT - Kutai
KZB - Kazembe
KZH - Khazak Horde
LAN - Florence
LAP - La Plata
LAU - Lauenburg
LDK - Ladakh
LDU - Lundu
LEB - Lebanon
LEI - Leinster
LEN - Lenape
LFA - Lanfang
LIE - Liege
LIG - Ligor
LIT - Lithuania
LIV - LivonianOrder
LNA - LanNa
LND - Lunda
LNG - Liang
LNO - Lanao
LOA - Loango
LOI - TheIsles
LON - Leon
LOR - Lorraine
LOU - Lousiana
LRI - Luristan
LUA - Luang Prabang
LUB - Luba
LUC - Lucca
LUN - Luneburg
LUW - Luwu
LUX - Luxembourgh
LVA - Livonia
LWA - Limbuwan
LXA - LanXang
MAB - Malabar
MAD - Madurai
MAE - Maeda
MAG - Magdeburg
MAH - Mahican
MAI - Mainz
MAJ - Majapahit
MAK - Makuria
MAL - Mali
MAM - Mameluks
MAN - Mantua
MAR - Marathas
MAS - Madyas
MAW - Marwar
MAY - Maya
MAZ - Mazovia
MBA - Mombasa
MBL - Bishnupur
MCA - Muisca
MCH - Manchu
MCM - MacCarthy
MDA - Medina
MDI - Mogadishu
MED - Medri Bahri
MEI - Meissen
MEM - Memmingen
MEN - Mentese
MER - Mewar
MEW - Mewat
MEX - Mexico
MFA - Montferrat
MFL - Mikhlaf
MFY - Mahafaly
MGD - Maguindanao
MGE - Mongol Empire
MGR - Maregh
MHR - Mahra
MHX - Haixi
MIK - Mikmaq
MIN - Min
MIR - Merina
MIX - Mixtec
MJE - Majeereen
MJZ - Jianzhou
MKA - Mong Kawng
MKL - Mecklenburg
MKP - Makwanpur
MKS - Makassar
MKU - Makua
MLB - Manipur
MLC - Malacca
MLI - Malindi
MLK - Karabakh
MLO - Milan
MLW - Malwa
MMA - Mong Mao
MMI - Miami
MNA - Manila
MNG - Ming
MNI - Mong Nai
MNS - Munster
MOD - Modena
MOE - Morea
MOL - Moldavia
MON - Montenegro
MOR - Morocco
MOS - Muscowy
MPA - Mong Pai
MPC - Mapuche
MPH - MuanPhuan
MRA - Maravi
MRE - Marehan
MRI - Mori
MSA - Malaya
MSI - Mossi
MSY - Mushashaiyyah
MTH - Meath
MTR - Mataram
MUG - Mughal
MUL - Multan
MUN - Munster
MVA - Moravia
MYA - MongYang
MYR - Yeren
MYS - Mysore
MZB - Mzab
NAG - Nagpur
NAH - Navajo
NAJ - Najd
NAP - Naples
NAT - Natives
NAV - Navarra
NAX - Naxos
NDO - Ndongo
NED - Netherlands
NEV - Nevers
NGA - Nagaur
NGP - Jharkhand
NJR - Najran
NKO - Nkore
NNG - Ning
NOG - Nogai
NOL - Northumberland
NOR - Norway
NOV - Novgorod
NPL - Nepal
NRM - Normandy
NSA - Nassau
NUB - Funj
NUM - Nuremberg
NUP - nupe
NVR - Navanagar
NZH - Nizhny Novgorod
ODA - Oda
ODH - Oudh
OGS - Ogasawara
OIR - OiratHorde
OJI - Ojibwa
OKA - Oka
OLD - Oldenburg
OMA - Oman
ORD - Ormond
ORI - Orissa
ORL - Orleans
ORM - Ormuz
OSA - Osage
OTM - Otomo
OTT - Ottawa
OUC - Ouchi
OYO - Oyo
PAL - Palatinate
PAN - Panna
PAP - Papal
PAR - Parma
PAT - Pattani
PAW - Pawnee
PCJ - Pacajes
PEG - Pegu
PEQ - Pequot
PER - Persia
PEU - Peru
PGR - Pagarruyung
PGS  - Pangasinan
PHA - Phagmodrupa
PIC - Picardy
PIM - Pima
PIR - Pirates
PIS - Pisa
PLB - Palembang
PLC - The Commonwealth
PLT - Polotsk
POL - Poland
POM - Pommern
POR - Portugal
POT - Potawatomi
POW - Powhatan
PRB - Porbandar
PRD - Parlakhimidi
PRG - Paraguay
PRK - Perak
PRM - Perm
PRO - Provence
PRU - Prussia
PSA - Pasai
PSK - Pskov
PTA - Patiala
PTE - Pate
PTG - Potiguara
PTL - Palitana
PTT - Patna
PUE - Pueblo
PUN - Punjab
QAR - Qara Koyunlu
QAS - QasimKhanate
QIC - Qi
QIN - Qin
QNG - Qing
QOM - Qom
QTO - Quito
QUE - Quebec
RAG - Ragusa
RAM - Ramazan
RAS - Rassids
REB - Rebel Scum
RFR - Nanbu
RIG - Riga
RJK - Rajkot
RJP - Rajputana
RMN - Romania
RMP - Rohilkhand
ROM - RomanEmpire
RSO - Rostov
RTT - Ratanpur
RUM - Rum
RUS - Russia
RVA - Ravensburg
RWA - Rwanda
RYA - Ryazan
RYU - Ryukyu
RZW - Butua
SAK - Siak
SAL - Salish
SAR - Sardinia
SAV - Savoy
SAX - Saxony
SBA - Shiba
SBP - Sambalpur
SCA - Scandinavia
SCO - Scotland
SDY - Sadiya
SER - Serbia
SFA - Sofala
SHA - Shawnee
SHL - Holstein
SHM - Shammar
SHN - Shoni
SHO - Shoshone
SHR - Sharjah
SHU - Shu
SHY - Shaybanid
SIB - Sibir
SIC - Sicily
SIE - Siena
SIL - Silesia
SIO - Sioux
SIS - Sistan
SKA - Sakalava
SKK - Sikkim
SLN - Sligo
SLO - Nyitra
SLZ - Salzburg
SME - Samthske
SMI - Sami
SMO - Smolensk
SMZ - Shimazu
SND - Sind
SOA - Shewa
SOF - Sofala
SOK - Sokoto
SON - Songhai
SOS - Sus
SPA - Spain
SPI - SardiniaPiedmont
SRG - Surguja
SRH - Sirhind
SRM - Sirmur
SRU - Saruhan
SRV - Shirvan
SST - Shan
STK - Satake
STY - Styria
SUK - Sukhothai
SUL - Sulu
SUN - Sunda
SUS - Susquehannock
SWE - Sweden
SWI - Switzerland
SYG - Sarigyogir
SYN - Synthetics
SYO - Soyo
SYR - Syria
TAB - Tabarestan
TAR - Tarascan
TAU - Taungu
TBK - Tumbuka
TBR - Tabriz
TDO - Tondo
TER - Ternate
TEU - Teutonic Order
TFL - Tafilalt
TGT - Touggourt
THU - Thuringia
TIB - Tibet
TID - Tidore
TIM - Timurid Empire
TIR - Tyrol
TKD - Takeda
TKG - Tokugawa
TKI - Toki
TLA - Tlapanec
TLC - Tlemcen
TLG - Telingana
TLX - Tlaxcala
TMB - Timbuktu
TNG - Tang
TNJ - Tanjore
TOK - Tonkin
TOT - Totonac
TOU - Toulouse
TPA - Tupinamba
TPQ - Tupiniquim
TPR - Tripura
TRA - Transylvania
TRE - Trebizond
TRI - Trier
TRP - Tripoli
TRS - Transoxiana
TRT - Tirhut
TRY - Tyrconnell
TTI - Tsutsui
TUA - Tapuia
TUN - Tunisia
TUR - Ottoman Empire
TUS - Tuscany
TVE - Tver
TYO - Tyo
TYR - Tyrone
UBH - Buha
UES - Uesugi
UKR - Ukraine
ULM - Ulm
ULS - Ulster
URB - Urbino
USA - United States
UTN - Utsunomiya
UTR - Utrecht
UTS - Utsang
VEN - Venice
VER - Verden
VIE - Vientiane
VIJ - Vijayanagar
VND - Venad
VNZ - Venezuela
VOL - Volyn
WAL - Wallachia
WAR - Warsangali
WBG - Wurzburg
WCR - Cree
WES - Westfalia
WIC - Wichita
WKA - Wanka
WLS - Wales
WLY - Welayta
WUR - Wurttemberg
WUU - Wu
XIU - Xiu
YAK - Yaka
YAN - Yan
YAO - Yao
YAR - Yaroslavl
YAS - Beni Yas
YAT - Yatenga
YEM - Yemen
YMN - Yamana
YOR - Andhra
YUA - Yuan
YUE - Yue
YZD - Yazd
ZAF - Zafunu
ZAN - Zwahili
ZAP - Zapotec
ZAZ - Zaporozhie
ZIM - Mutapa
ZUN - Zunghar
ZZZ - Zazzau










